111111111111111111111111111111111111
10000010C01C000000000000000000000001
10P010100010000000000000000000000001
10C010000000000000000000000000000001
10C010000000000000000000000000000001
10C010000000000000000000000000000001
10C010000000000000000000001110000001
10C01000000000000000000000EC10000001
10C010000000000000000000001110000001
10C010000000000000000000000000000001
100000000000000000000000000000000001
111111111111111111111111111111111111
