1111111111
1000C00E11
1000111111
1000001011
10P0001111
1111111111







