1111111111
1000C0CE11
1000111111
1000001011
10P0001111
1111111111







