11111111111
1000C00E011
10000000011
10P00011011
10000000011
11111111111