11111111111111111
10000010C01C00001
10P01010001000E01
10C01000000000001
11111111111111111
