1111111111
10000010E1
10P0101001
10C0100001
1111111111
