1111111111
10P00001E1
11111C0111
10C0100001
1111111111
