1111111111
10P00001E1
11101C0101
10C0100001
1111111111
